                                                                                      D
                                                                                      D
                                                                                      D
       BBBBBBCCCCCCCCCCCCCCCCCCCCCCCCCCCCCCCCCCCCCCCCCCCC                             D
                                                                           C          D
                                                                          CC          D
             CGCCCCCCCCCCCCCGCCCC            DDDDBBBCCCCCCCCCCCCC        CCC          D
                                                                        CCCC          D
                                                                       CCCCC          D
FFFFFFFFFFFFFFFFFFFFFFFFFFFFFFFFFFFFFF    FFFFFFFFFFFFFFFFFFFFFFFFFFFFFFFFFFFFFFFFFFFFF
DDDDDDDDDDDDDDDDDDDDDDDDDDDDDDDDDDDDDD    DDDDDDDDDDDDDDDDDDDDDDDDDDDDDDDDDDDDDDDDDDDDD
DDDDDDDDDDDDDDDDDDDDDDDDDDDDDDDDDDDDDD    DDDDDDDDDDDDDDDDDDDDDDDDDDDDDDDDDDDDDDDDDDDDD